border_size=1
usage=map

Aa          , Aa          , Aa          , Xv          , Aa          , Aa          , Aa          , Xv          , Xv          , Xv          , Aa          , Aa          , Aa          , Xv          , Xv          , Xv          , Xv          , Xv          , Xv          , Xv          , Xv          , Xv          
Aa          , Aa          , Aa          , Aa          , Aa          , Aa          , Aa          , Aa          , Aa          , Aa          , Aa          , Aa          , Aa          , Aa          , Aa          , Xv          , Xv          , Xv          , Xv          , Xv          , Xv          , Xv          
Aa          , Aa          , Aa          , Aa          , Aa          , Aa          , Aa          , Aa          , Aa          , Aa          , Aa          , Aa          , Aa          , Aa          , Xv          , Aa          , Aa          , Xv          , Xv          , Aa          , Xv          , Xv          
Aa          , Aa          , Aa          , Aa          , Aa          , Aa          , Aa          , Aa          , Aa          , Aa          , Aa          , Aa          , Aa          , Aa          , Aa          , Xv          , Aa          , Xv          , Aa          , Aa          , Xv          , Xv          
Aa          , Aa          , Aa          , Aa          , Aa          , Aa          , Aa          , Aa          , Aa          , Aa          , Xv          , Aa          , Xv          , Xv          , Aa          , Aa          , Aa          , Aa          , Aa          , Xv          , Xv          , Xv          
Xv          , Aa          , Xv          , Aa          , Aa          , Xv          , Xv          , Aa          , Aa          , Aa          , Xv          , Xv          , Xv          , Xv          , Aa          , Aa          , Aa          , Aa          , Aa          , Xv          , Xv          , Xv          
Xv          , Xv          , Xv          , Aa          , Aa          , Aa          , Aa          , Aa          , Aa          , Aa          , Aa          , Aa          , Aa          , Aa          , Aa          , Aa          , Aa          , Aa          , Xv          , Xv          , Xv          , Xv          
Aa          , Aa          , Aa          , Xv          , Xv          , Aa          , Xv          , Xv          , Xv          , Xv          , Xv          , Xv          , Xv          , Aa          , Aa          , Aa          , Xv          , Xv          , Xv          , Xv          , Aa          , Xv          
Aa          , Aa          , Aa          , Xv          , Xv          , Xv          , Xv          , Xv          , Xv          , Xv          , Xv          , Xv          , Xv          , Xv          , Xv          , Xv          , Xv          , Xv          , Aa          , Aa          , Aa          , Aa          
Aa          , Aa          , Aa          , Aa          , Aa          , Aa          , Xv          , Xv          , Xv          , Xv          , Xv          , Xv          , Xv          , Xv          , Xv          , Xv          , Xv          , Xv          , Aa          , Aa          , Aa          , Aa          
Aa          , Aa          , Xv          , Aa          , Xv          , Xv          , Xv          , Xv          , Xv          , Xv          , Xv          , Xv          , Xv          , Xv          , Aa          , Xv          , Xv          , Xv          , Aa          , Aa          , Aa          , Aa          
Aa          , Aa          , Xv          , Xv          , Xv          , Xv          , Xv          , Xv          , Xv          , Xv          , Aa          , Aa          , Aa          , Aa          , Xv          , Aa          , Xv          , Xv          , Xv          , Aa          , Xv          , Xv          
Aa          , Aa          , Xv          , Xv          , Xv          , Xv          , Xv          , Xv          , Xv          , Aa          , Xv          , Aa          , Xv          , Xv          , Xv          , Xv          , Aa          , Xv          , Xv          , Xv          , Xv          , Xv          
Aa          , Aa          , Aa          , Aa          , Aa          , Xv          , Xv          , Xv          , Xv          , Xv          , Xv          , Xv          , Xv          , Xv          , Xv          , Aa          , Aa          , Aa          , Xv          , Xv          , Xv          , Xv          
Aa          , Aa          , Aa          , Aa          , Aa          , Xv          , Xv          , Xv          , Xv          , Xv          , Xv          , Xv          , Xv          , Xv          , Aa          , Aa          , Aa          , Xv          , Xv          , Xv          , Xv          , Xv          
Aa          , Aa          , Aa          , Aa          , Aa          , Aa          , Aa          , Xv          , Xv          , Xv          , Xv          , Xv          , Aa          , Xv          , Aa          , Aa          , Xv          , Xv          , Xv          , Xv          , Xv          , Xv          
Aa          , Aa          , Xv          , Aa          , Aa          , Aa          , Aa          , Xv          , Xv          , Xv          , Xv          , Aa          , Aa          , Aa          , Xv          , Xv          , Xv          , Xv          , Xv          , Xv          , Xv          , Xv          
Xv          , Xv          , Xv          , Xv          , Xv          , Aa          , Xv          , Xv          , Xv          , Xv          , Xv          , Xv          , Xv          , Xv          , Xv          , Xv          , Xv          , Xv          , Xv          , Xv          , Xv          , Xv          
Aa          , Aa          , Aa          , Xv          , Xv          , Xv          , Xv          , Xv          , Xv          , Xv          , Xv          , Xv          , Xv          , Xv          , Xv          , Xv          , Xv          , Xv          , Xv          , Xv          , Xv          , Xv          
Aa          , Aa          , Aa          , Xv          , Aa          , Aa          , Xv          , Xv          , Xv          , Xv          , Aa          , Aa          , Xv          , Xv          , Xv          , Xv          , Xv          , Xv          , Xv          , Xv          , Aa          , Xv          
Aa          , Aa          , Aa          , Aa          , Xv          , Aa          , Xv          , Xv          , Aa          , Aa          , Aa          , Aa          , Xv          , Xv          , Xv          , Xv          , Xv          , Xv          , Xv          , Aa          , Aa          , Aa          
Aa          , Aa          , Aa          , Aa          , Xv          , Xv          , Xv          , Xv          , Xv          , Xv          , Xv          , Xv          , Xv          , Xv          , Xv          , Xv          , Xv          , Xv          , Xv          , Aa          , Aa          , Aa          
Aa          , Aa          , Aa          , Xv          , Xv          , Xv          , Xv          , Xv          , Xv          , Xv          , Xv          , Xv          , Xv          , Xv          , Xv          , Xv          , Xv          , Xv          , Xv          , Aa          , Aa          , Aa          
Aa          , Aa          , Aa          , Aa          , Aa          , Xv          , Xv          , Xv          , Xv          , Aa          , Aa          , Aa          , Aa          , Xv          , Xv          , Xv          , Xv          , Xv          , Xv          , Xv          , Aa          , Aa          
Aa          , Aa          , Aa          , Aa          , Aa          , Aa          , Xv          , Xv          , Aa          , Aa          , Aa          , Aa          , Aa          , Xv          , Xv          , Xv          , Xv          , Xv          , Xv          , Xv          , Aa          , Aa          
Aa          , Aa          , Aa          , Xv          , Xv          , Aa          , Xv          , Xv          , Xv          , Xv          , Xv          , Aa          , Xv          , Xv          , Xv          , Xv          , Xv          , Xv          , Xv          , Xv          , Aa          , Aa          
Aa          , Aa          , Aa          , Xv          , Xv          , Xv          , Xv          , Xv          , Xv          , Xv          , Xv          , Xv          , Xv          , Xv          , Xv          , Xv          , Xv          , Xv          , Xv          , Xv          , Aa          , Aa          
Aa          , Aa          , Aa          , Xv          , Xv          , Xv          , Xv          , Xv          , Aa          , Xv          , Xv          , Xv          , Xv          , Xv          , Xv          , Xv          , Xv          , Xv          , Xv          , Xv          , Aa          , Aa          
Aa          , Aa          , Aa          , Xv          , Xv          , Aa          , Aa          , Aa          , Aa          , Aa          , Xv          , Xv          , Xv          , Xv          , Xv          , Xv          , Xv          , Xv          , Aa          , Aa          , Aa          , Aa          
Aa          , Aa          , Aa          , Xv          , Xv          , Aa          , Aa          , Aa          , Xv          , Xv          , Xv          , Xv          , Xv          , Xv          , Xv          , Xv          , Xv          , Aa          , Aa          , Aa          , Xv          , Xv          
Aa          , Aa          , Aa          , Xv          , Xv          , Aa          , Xv          , Xv          , Xv          , Xv          , Xv          , Xv          , Xv          , Xv          , Xv          , Xv          , Aa          , Aa          , Xv          , Xv          , Xv          , Xv          
Aa          , Aa          , Aa          , Xv          , Xv          , Xv          , Xv          , Xv          , Xv          , Xv          , Xv          , Xv          , Xv          , Xv          , Aa          , Aa          , Xv          , Xv          , Aa          , Aa          , Aa          , Aa          
Aa          , Aa          , Aa          , Xv          , Xv          , Xv          , Xv          , Xv          , Xv          , Xv          , Xv          , Aa          , Xv          , Aa          , Xv          , Xv          , Aa          , Aa          , Aa          , Aa          , Aa          , Aa          
Aa          , Aa          , Aa          , Xv          , Xv          , Xv          , Xv          , Xv          , Xv          , Xv          , Xv          , Xv          , Aa          , Xv          , Aa          , Aa          , Aa          , Aa          , Aa          , Aa          , Aa          , Xv          
Aa          , Aa          , Aa          , Xv          , Xv          , Xv          , Aa          , Aa          , Xv          , Xv          , Xv          , Aa          , Aa          , Aa          , Aa          , Aa          , Aa          , Aa          , Aa          , Aa          , Aa          , Xv          
Aa          , Aa          , Aa          , Xv          , Xv          , Xv          , Aa          , Aa          , Xv          , Xv          , Xv          , Xv          , Aa          , Aa          , Aa          , Aa          , Aa          , Aa          , Aa          , Aa          , Aa          , Xv          
Aa          , Aa          , Aa          , Xv          , Xv          , Xv          , Xv          , Aa          , Xv          , Xv          , Xv          , Aa          , Aa          , Aa          , Aa          , Aa          , Aa          , Aa          , Aa          , Aa          , Aa          , Xv          
Aa          , Aa          , Aa          , Xv          , Xv          , Xv          , Xv          , Xv          , Xv          , Xv          , Xv          , Aa          , Aa          , Aa          , Aa          , Aa          , Aa          , Aa          , Aa          , Aa          , Aa          , Xv          
Aa          , Aa          , Aa          , Xv          , Xv          , Xv          , Xv          , Xv          , Xv          , Xv          , Xv          , Xv          , Aa          , Aa          , Aa          , Aa          , Aa          , Aa          , Aa          , Aa          , Aa          , Aa          
Xv          , Aa          , Xv          , Xv          , Xv          , Xv          , Xv          , Xv          , Xv          , Xv          , Aa          , Aa          , Aa          , Aa          , Aa          , Aa          , Aa          , Aa          , Aa          , Aa          , Aa          , Aa          
Xv          , Xv          , Xv          , Xv          , Xv          , Xv          , Xv          , Xv          , Xv          , Xv          , Aa          , Aa          , Aa          , Aa          , Aa          , Aa          , Aa          , Aa          , Aa          , Aa          , Aa          , Aa          
Xv          , Xv          , Xv          , Xv          , Aa          , Aa          , Aa          , Aa          , Xv          , Xv          , Aa          , Aa          , Aa          , Aa          , Aa          , Aa          , Aa          , Aa          , Aa          , Aa          , Aa          , Aa          
Xv          , Xv          , Aa          , Aa          , Aa          , Aa          , Aa          , Aa          , Xv          , Xv          , Xv          , Aa          , Aa          , Aa          , Aa          , Aa          , Aa          , Aa          , Aa          , Aa          , Aa          , Aa          
Aa          , Aa          , Aa          , Aa          , Aa          , Aa          , Aa          , Aa          , Xv          , Xv          , Xv          , Xv          , Xv          , Xv          , Xv          , Aa          , Aa          , Aa          , Aa          , Aa          , Aa          , Aa          
Aa          , Aa          , Aa          , Aa          , Aa          , Aa          , Aa          , Aa          , Xv          , Xv          , Xv          , Xv          , Xv          , Xv          , Xv          , Aa          , Aa          , Aa          , Aa          , Aa          , Aa          , Xv          
Aa          , Aa          , Aa          , Aa          , Aa          , Aa          , Aa          , Aa          , Xv          , Xv          , Xv          , Xv          , Xv          , Xv          , Xv          , Aa          , Aa          , Aa          , Xv          , Aa          , Xv          , Xv          
Aa          , Aa          , Aa          , Aa          , Aa          , Aa          , Aa          , Aa          , Xv          , Xv          , Xv          , Xv          , Xv          , Xv          , Xv          , Xv          , Xv          , Xv          , Xv          , Xv          , Xv          , Xv          
Gg          , Aa          , Aa          , Aa          , Aa          , Aa          , Aa          , Aa          , Xv          , Xv          , Xv          , Xv          , Xv          , Xv          , Xv          , Xv          , Xv          , Xv          , Xv          , Xv          , Xv          , Xv          
